301111111111111111111
001000001010000000101
101011101011101010101
100010000000101010001
101111101111111011101
101000001000000000101
101110101110111111101
101000101010000010101
111111101011111010111
100000000000000000000
111111111111111111190
