301111111111111111111
000000100000100010001
101111101110101110101
100000000010000010101
111110111011111010111
100010001000101000001
111010111110101110111
100000001010001000101
101111101011101011101
100000100010001000000
111111111111111111190
